R  900 600

NO ./path/north_texture.xpm
SO ./path/south_texture.xpm
WE ./path/west_texture.xpm
EA ./path/east_texture.xpm

S ./path/sprite_texture.xpm

F 70,70,70
C 0,255,255

 111111111
10004002001
10N01111141
10001   101
11111  1002111111111111111
13001 1200011022222222201
102011000001 10000000001
120104000301  102222201
101001111111   1000001
1410201         10001
100200111111111111011
 10001 1103400002201
  131  122211102201
  1411110001 12201
  1000000001 1001
  1111111111 111