R  900 600

NO ./path/north_texture.xpm
SO ./path/south_texture.xpm
WE ./path/west_texture.xpm
EA ./path/east_texture.xpm

S ./path/sprite_texture.xpm

F 70,70,70
C 0,255,255

111111111111
122220002221
122220N02221
122220002221
111111111111